continent_1 = {
	provinces = {
		8 10 12 13 14 15 16 17 18 19 20 21 22 23 24 25 27 28 29 30 31 32 33 34 35 36 37 38 40 41 42 43 44 45 46 47 48 49 50 51 52 53 57 58 59 60 62 64 66 67 68 69 70 71 73 75 76 78 79 80 81 82 83 84 85 86 87 88 90 91 92 93 95 96 97 98 99 100 101 102 104 105 106 109 110 111 112 113 114 115 117 118 119 120 121 122 123 124 125 126 127 128 129 130 131 132 133 134 135 137 138 139 140 141 142 143 144 145 146 147 148 149 150 151 152 153 154 157 158 159 160 161 162 163 164 165 167 168 169 170 171 172 173 174 175 176 177 178 179 180 181 182 183 184 185 186 187 188 189 191 192 193 194 195 197 198 199 200 201 202 203 204 205 206 207 208 209 210 213 215 216 217 218 219 220 221 222 223 224 226 227 228 230 231 232 233 234 235 236 239 240 241 242 243 244 245 246 247 249 250 251 252 253 254 255 256 257 258 259 260 261 262 263 264 265 266 267 268 269 270 271 272 274 276 278 279 280 281 282 283 284 285 286 287 288 289 290 291 292 293 294 295 296 297 298 300 301 302 303 304 305 306 307 308 309 310 311 312 313 314 315 316 317 318 319 320 321 323 325 326 327 328 329 332 334 335 336 337 338 339 340 341 343 344 345 346 348 350 351 352 354 355 356 357 358 359 361 362 365 366 367 368 370 371 372 373 374 375 376 379 380 384 385 386 387 388 389 392 393 395 396 397 398 399 400 401 404 405 406 407 408 409 410 411 412 413 417 419 420 421 423 424 425 426 428 429 430 432 433 435 436 437 438 439 440 441 442 446 447 448 449 450 455 456 457 458 459 462 463 467 468 469 470 471 472 473 474 475 477 479 481 482 483 486 487 488 491 492 493 497 498 499 500 501 502 504 505 506 507 509 510 511 513 514 516 518 519 520 521 523 524 525 526 527 528 529 533 534 536 539 540 541 542 543 547 548 549 551 552 553 556 557 558 559 560 561 562 566 567 568 569 570 571 572 573 575 576 578 579 580 583 586 587 589 590 591 592 595 596 597 600 601 604 606 607 609 611 612 613 614 616 617 619 620 621 626 628 629 631 632 634 635 640 641 644 646 647 648 655 657 666 669 670 671 672 673 674 676 683 685 689 693 699 701 704 708 710 713 714 717 753 758 765 782 789 793 794 803 817 831 859 860 869 872 896 927 

		538 565 574 585 593 605 610 625 627 649 654 662 679 696 698 700 709 712 727 730 734 735 736 742 762 763 764 769 770 773 774 791 802 809 820 825 837 880 881 889 918 924 931 945 946 955 970 974 997 1010 1026 1032 1037 1048 1062 1064 1065 1097 1125 1148 1164 1217 1262 1263 1271 1287 1359 1364 1419 1432 1438 1497 1566 1626 1629 

				322 324 330 331 333 342 347 349 363 364 369 377 381 382 383 390 391 394 402 403 414 415 416 418 422 427 431 434 443 444 445 451 452 454 460 461 464 465 466 476 478 480 484 490 494 495 496 503 508 515 522 530 531 532 535 537 544 545 550 554 563 564 577 581 582 584 588 598 599 602 603 608 615 618 622 623 630 633 637 638 639 650 651 652 653 656 658 659 660 661 663 664 665 667 668 675 678 682 686 687 688 690 691 692 695 703 705 706 707 715 716 722 725 726 728 729 733 741 747 750 751 755 761 768 772 779 780 781 785 786 787 788 800 801 805 814 818 819 823 824 830 833 836 840 842 843 844 845 848 849 855 856 857 858 868 874 875 876 887 888 892 893 894 899 900 902 903 905 906 907 908 911 917 922 923 926 929 930 944 947 948 949 952 953 954 958 959 960 962 963 978 983 989 990 991 993 994 996 1000 1001 1003 1004 1006 1013 1014 1018 1022 1027 1029 1031 1036 1044 1045 1046 1047 1055 1058 1066 1072 1078 1083 1084 1096 1102 1107 1108 


		6 9 74 89 196 211 212 277 299 512 546 624 864 1067 1483 1496 1569 1711 1718 1725 1811 1828 1841 1886 1897 1938 1940 1963 2017 2028 2036 2056 2144 2175 2176 2183 2216 2242 2247 2286 2324 2325 2326 2328 2342 2343 2344 2345 2346 2347 2348 2349 2350 2351 2352 2353 2354 


		214 248 275 353 489 594 642 680 694 977 1133 1200 1236 1253 1261 1281 1340 1363 1400 1426 1467 1534 1540 1611 1667 1759 1764 1817 1871 1904 1925 1929 1935 1967 1974 1978 1992 2013 2051 2087 2092 2138 2158 2214 2224 

		538 565 574 585 593 605 610 625 627 649 654 662 679 696 698 700 709 712 727 730 734 735 736 742 762 763 764 769 770 773 774 791 802 809 820 825 837 880 881 889 918 924 931 945 946 955 970 974 997 1010 1026 1032 1037 1048 1062 1064 1065 1097 1125 1148 1164 1217 1262 1263 1271 1287 1359 1364 1419 1432 1438 1497 1566 1626 1629 

		636 643 677 681 684 697 702 711 718 719 720 721 723 724 731 732 737 738 739 740 743 744 745 746 748 749 754 756 757 759 760 766 767 771 775 776 777 778 783 784 790 795 796 797 798 799 804 806 807 808 810 811 812 813 822 826 827 828 829 832 835 838 839 841 846 847 851 852 853 861 862 863 866 867 873 883 886 891 897 912 

		816 821 834 865 877 884 935 942 943 950 967 981 984 1007 1011 1023 1033 1034 1049 1050 1073 1079 1080 1089 1093 1098 1109 1110 1111 1120 1135 1140 1146 1153 1156 1175 1176 1178 1179 1180 1188 1193 1194 1207 1211 1218 1219 1220 1233 1234 1246 1250 1264 1265 1266 1267 1277 1280 1293 1299 1308 1312 1320 1326 1327 1328 1348 1354 1360 1361 1365 1391 1392 1395 1396 1401 1409 1410 1412 1413 1417 1418 1420 1421 1422 1423 1433 1434 1439 1443 1444 1461 1464 1470 1471 1475 1480 1484 1487 1488 1489 1498 1499 1503 1504 1507 1516 1524 1526 1527 1528 1530 1536 1541 1542 1547 1548 1553 1554 1555 1560 1561 1563 1564 1570 1575 1578 1582 1585 1590 1591 1595 1605 1608 1609 1612 1613 1619 1627 1630 1631 1632 1636 1638 1640 1647 1651 1666 1669 1671 1675 1679 1681 

		882 885 890 895 898 901 904 909 913 914 915 919 920 928 932 933 936 937 938 939 951 957 961 964 968 969 971 972 975 976 979 982 985 986 987 995 998 999 1005 1008 1012 1015 1016 1017 1019 1020 1021 1024 1028 1035 1038 1039 1040 1041 1043 1051 1052 1053 1054 1056 1059 1060 1061 1068 1074 1075 1076 1081 1087 1088 1090 1091 1094 1099 1103 1104 1112 1119 1121 1122 1126 1127 1129 1131 1132 1136 1144 1145 1154 1157 1158 1159 1165 1169 1170 1171 1174 1181 1184 1186 1189 1195 1196 1197 1198 1202 1208 1212 1213 1214 1221 1223 1224 1225 1228 1229 1235 1238 1239 1242 1248 1251 1252 1256 1257 1258 1268 1272 1284 1285 1288 1294 1295 1300 1301 1302 1303 1304 1305 1306 1313 1314 1315 1321 1322 1329 1333 1334 1335 1336 1337 1349 1350 1355 1356 1357 1358 1362 1366 1371 1374 1375 1376 1380 1381 1382 1384 1387 1388 1393 1394 1397 1398 1402 1403 1404 1414 1424 1427 1435 1441 1445 1446 1449 1450 1451 1454 1458 1465 1466 1468 1472 1476 1477 1485 1486 1490 1505 1508 1509 1513 1514 1520 1521 1525 1529 1531 1537 1543 1544 1549 1550 1556 1562 1565 1567 1568 1571 1579 1580 1586 1587 1588 1596 1597 1600 1602 1603 1604 1606 1610 1614 1616 1617 1633 1634 1641 1642 1643 1644 1648 1652 1653 1656 1657 1658 1660 1661 1662 1663 1672 1673 1676 1682 1683 1684 1685 1686 1689 1690 1694 1696 1697 1698 1699 1701 1702 1708 1712 1715 1716 1719 1720 1721 1723 1724 1726 1727 1730 1731 1732 1734 1735 1736 1739 1740 1742 1743 1744 1745 1746 1748 1749 1751 1753 1754 1755 1758 1760 1762 1766 1767 1771 1772 1773 1774 1775 1776 1777 1778 1779 1780 1781 1782 1784 1785 1788 1789 1790 1791 1794 1795 1798 1799 1801 1802 1804 1805 1806 1807 1808 1809 1812 1816 1820 1821 1823 1824 1826 1827 1829 1830 1831 1832 1836 1837 1838 1840 1842 1843 1845 1851 1852 1853 1858 1859 1861 1862 1864 1868 1869 1870 1873 1875 1876 1877 1880 1881 1883 1887 1888 1890 1891 1900 1901 1902 1903 1906 1907 1908 1909 1915 1918 1921 1922 1923 1930 1931 1933 1934 1939 1941 1943 1944 1949 1950 1951 1957 1958 1959 1960 1961 1964 1965 1966 1969 1973 1977 1982 1985 1988 1991 1995 1998 1999 2000 2003 2007 2009 2015 2040 2041 2042 2043 2059 2084 2105 

		925 934 941 965 973 988 1002 1009 1025 1030 1057 1063 1070 1071 1077 1082 1085 1092 1095 1100 1101 1105 1113 1114 1116 1117 1123 1128 1130 1134 1137 1138 1141 1142 1143 1147 1149 1150 1151 1152 1155 1160 1161 1162 1163 1166 1167 1168 1172 1173 1177 1182 1185 1187 1190 1191 1192 1199 1203 1204 1205 1206 1209 1210 1215 1216 1222 1226 1227 1230 1231 1232 1237 1240 1241 1243 1244 1245 1247 1249 1254 1255 1259 1260 1269 1270 1273 1274 1275 1276 1278 1279 1282 1286 1289 1290 1291 1292 1296 1297 1298 1307 1309 1310 1311 1316 1317 1318 1319 1323 1324 1325 1330 1331 1332 1338 1339 1341 1342 1343 1344 1345 1346 1347 1351 1352 1353 1368 1369 1370 1372 1373 1377 1378 1379 1383 1385 1386 1389 1390 1399 1405 1406 1407 1411 1415 1416 1425 1428 1429 1430 1431 1436 1437 1440 1442 1447 1448 1452 1453 1455 1456 1457 1459 1460 1462 1463 1469 1473 1474 1478 1479 1481 1482 1491 1492 1493 1494 1495 1500 1501 1502 1506 1511 1515 1517 1518 1519 1522 1523 1532 1533 1535 1538 1539 1545 1551 1552 1557 1558 1572 1573 1576 1577 1581 1583 1584 1589 1592 1593 1594 1598 1599 1601 1607 1615 1618 1620 1621 1622 1623 1624 1625 1628 1635 1639 1645 1646 1649 1650 1654 1655 1659 1664 1665 1668 1677 1678 1688 1693 1704 1722 1741 1756 

		1680 1687 1700 1703 1705 1709 1710 1713 1717 1728 1733 1737 1738 1750 1752 1757 1761 1765 1768 1770 1783 1786 1787 1792 1796 1797 1800 1803 1810 1813 1814 1815 1818 1819 1822 1825 1833 1834 1835 1844 1846 1847 1848 1849 1850 1854 1855 1856 1857 1860 1863 1865 1866 1867 1872 1874 1878 1879 1882 1884 1885 1889 1892 1893 1894 1895 1896 1899 1905 1910 1911 1912 1913 1914 1916 1917 1919 1920 1924 1926 1927 1928 1932 1936 1937 1942 1945 1946 1947 1948 1952 1953 1954 1955 1956 1962 1968 1970 1975 1976 1979 1981 1983 1986 1987 1989 1993 2004 2005 2006 2008 2010 2011 2012 2014 2021 2023 2026 2027 2032 2033 2034 2035 2038 2044 2054 2060 2061 2064 2065 2069 2070 2072 2074 2075 2079 2080 2082 2083 2085 2086 2088 2089 2095 2096 2099 2100 2102 2106 2107 2108 2109 2111 2112 2114 2119 2122 2123 2125 2129 2132 2133 2136 2139 2141 2145 2151 2152 2153 2159 2160 2161 2167 2168 2187 
		
		1980 1984 1990 1994 1996 1997 2002 2018 2020 2022 2024 2029 2030 2031 2037 2039 2045 2046 2047 2048 2049 2050 2052 2053 2057 2062 2063 2066 2067 2071 2073 2076 2077 2078 2081 2090 2091 2093 2094 2097 2098 2101 2103 2104 2110 2113 2115 2116 2117 2118 2120 2121 2126 2127 2128 2130 2131 2134 2135 2137 2140 2142 2143 2146 2147 2148 2149 2150 2154 2155 2157 2162 2163 2164 2165 2166 2169 2170 2171 2172 2173 2174 2177 2178 2179 2181 2182 2184 2185 2186 2188 2189 2190 2191 2192 2193 2194 2195 2196 2197 2198 2199 2200 2201 2202 2203 2204 2205 2206 2207 2208 2209 2210 2211 2212 2213 2215 2217 2218 2219 2220 2221 2222 2223 2225 2226 2227 2228 2229 2230 2231 2232 2233 2234 2235 2236 2237 2238 2239 2240 2241 2243 2244 2245 2246 2248 2249 2250 2251 2252 2253 2254 2255 2256 2257 2258 2259 2260 2261 2262 2263 2264 2265 2266 2267 2268 2269 2270 2271 2272 2273 2274 2275 2276 2277 2278 2279 2280 2281 2282 2283 2284 2285 2287 2288 2289 2290 2291 2292 2293 2294 2296 2297 2298 2299 2300 2301 2302 2303 2304 2305 2306 2307 2308 2309 2310 2311 2312 2313 2314 2315 2316 2317 2318 2319 2320 2321 2322 2323 2327 2329 2330 2331 2332 2333 2334 2335 2336 2337 2338 2339 2340 2341 

		2295
	}
}



